ABD = "countries/ABD-AbydosDesert.txt"
ABY = "countries/ABY-Abydos.txt"
ARI = "countries/ARI-Arius.txt"
CA1 = "countries/CA1-KivotosAutonomy1.txt"
CA2 = "countries/CA2-KivotosAutonomy2.txt"
CA3 = "countries/CA3-KivotosAutonomy3.txt"
CA4 = "countries/CA4-KivotosAutonomy4.txt"
CAB = "countries/CAB-Caesarbm.txt"
CAE = "countries/CAE-Caesar.txt"
CAH = "countries/CAH-Caesarhi.txt"
CAO = "countries/CAO-CaesarO.txt"
CAP = "countries/CAP-Caesarpmc.txt"
CEN = "countries/CEN-Centralstudentcouncil.txt"
GEH = "countries/GEH-Gehenna.txt"
HIL = "countries/HIL-Highland.txt"
HSP = "countries/HSP-Hspaniamilltary.txt"
HYA = "countries/HYA-Hyakkiyako.txt"
KRO = "countries/KRO-Kronos.txt"
MIL = "countries/MIL-Millennium.txt"
ODY = "countries/ODY-Odyssey.txt"
RWT = "countries/RWT-Redwinter.txt"
SCH = "countries/SCH-Schale.txt"
SHA = "countries/SHA-Shanhaijing.txt"
SRT = "countries/SRT-Specialresponseteam.txt"
STE = "countries/STE-Stelle.txt"
TRY = "countries/TRY-Trinity.txt"
VAL = "countries/VAL-Valkyrie.txt"
W00 = "countries/W00-MapUtilities.txt"
WLH = "countries/WLH-Wlidhunt.txt"
WS1 = "countries/WS1-SnowlandNorth.txt"
WS2 = "countries/WS2-SnowlandSouth.txt"
WS3 = "countries/WS3-SnowlandWest.txt"
WV1 = "countries/WV1-Volcano.txt"
